##############
#            #
#  ####%### ##
#         % ##
#  ######## ##
#  ###  ##  ##
#    #  ##  ##
#### ##%##   @
        ##  ##
##############
