##############
#            #
#  ####%### ##
#         % ##
#  ######## ##
#  ###  ##  ##
#    #  ##  ##
#### ##%##    
@       ##  ##
##############
