# ############
#            #
#  ###  ##  ##
#  ###  ##  ##
#       ##  ##
#       ##  ##
#       ##  ##
##########  ##
@           ##
##############
