###########@##
#           %#
#  ###   #  ##
#  #####%#  ##
#  ####  #  ##
#       ######
#           ##
########  ####
#         % ##
##############
