########### ##
#           %#
#  ###   #  ##
#  #####%#  ##
#  ####  #  ##
#       ######
#           ##
########  ####
#@        % ##
##############
